



F 220,100,0


C 22,530,0



        1111111111111111111111111
        1000000000110000000000001
        1011000001110000000000001
        1001000000000000000000001
11111111011000001110000000000001
100000000011000001110111111111111
1111011111111101110000001001
1111011111111101110101001001
1100000011010101110000001001
100000000000011000000100001
1000000000000000110101001011
011000001110101000111011110N111
11110111 1110101 1111111111111
11111111 1111111 11111111
